1110000111000011100000111111100111100111111000011110011100
1000000001100000001101110001100110110110000000001111100001
1101110011100001101110000001100110110110000100011000000001
1000011001110000001101110000111000000000011110001100000000
1000011110000000101100000011000000000000000111001111000001
1010010110000110111000011111100011000111100011110000000000
0110110110000001000000000000000111010100011000110111110000
1111000111110001111101111000110001111000111000011100000011
0000111100001100001000111001110011011100011110000111000100
0100010000000000001110110001110000000000000000000000110111
1000000000000001101110110001100111110000000011001111100001
0001111101010001100011101111110000111100000001101110001100
1110000001010001100000110001101110111000111001101100000111
1001111100010001111000111001100000110111000000001110011100
0001111001111100011101111000111110000001110011110000001100
1000000000010101101100110001000101110001110011000001100111
1101111100000000111100010000011110001111000000011000000001
1100000001100001110000111111001100000000000001111000011001
0011000001100111100001110011001100000000011100011111000011
0010010111000111000011000111000011011110011100011100011001
1000110000000100000000000000000111000000011110000111110001
0011111000111111100000111111000011100111111000011110011100